32 16
0 0 0 0 0 0 0 0 0 0 0 0 0 0 0 0 0 0 0 0 0 0 0 0 0 0 0 0 0 0 0 0 
0 0 0 0 0 0 0 0 0 0 0 0 0 0 0 0 0 0 0 0 0 0 0 0 0 0 0 0 0 0 0 0 
41 41 46 0 0 0 47 41 41 41 41 197 217 41 217 41 217 41 217 41 217 197 41 41 41 41 46 0 0 0 47 41 
57 65 215 114 115 95 216 65 57 57 57 57 57 57 57 57 57 57 57 57 57 57 65 57 57 57 215 95 114 115 216 57 
57 57 43 0 0 0 44 57 57 57 57 57 57 57 57 57 57 57 57 57 57 57 57 57 57 57 43 0 0 0 44 65 
57 57 43 0 0 0 44 57 57 57 57 65 57 57 57 57 57 57 57 57 57 57 57 57 57 57 219 0 0 0 44 57 
57 57 43 0 0 0 220 57 57 57 57 57 57 57 57 57 57 57 57 57 57 57 57 57 57 57 43 0 0 0 44 57 
57 57 43 0 0 0 44 57 57 57 57 57 57 57 57 57 65 57 57 57 57 57 57 57 57 65 219 0 0 0 44 57 
65 57 43 0 0 0 44 57 50 218 42 42 42 42 42 42 42 42 42 42 42 42 42 42 42 42 45 0 0 0 44 57 
57 57 43 0 0 0 44 57 43 0 0 0 0 0 0 0 0 0 0 0 0 0 0 0 0 0 0 0 0 0 44 57 
57 57 43 0 0 0 48 68 45 0 0 0 0 0 0 0 0 0 0 0 0 0 0 0 0 0 0 0 0 0 44 57 
57 65 43 0 0 0 0 0 0 0 0 111 0 47 41 41 41 41 41 41 46 0 0 0 0 0 0 0 0 0 44 57 
57 57 61 41 41 41 41 41 46 0 0 81 0 44 57 57 57 57 57 65 49 54 58 0 0 0 0 0 0 0 140 65 
57 57 57 57 65 57 57 57 61 41 41 213 41 62 57 57 57 57 57 57 57 63 53 54 58 0 0 0 0 0 44 57 
57 57 57 57 57 57 57 57 57 57 65 65 65 57 57 65 57 57 57 57 57 57 57 63 53 41 41 41 41 41 52 57 
57 57 57 57 57 57 57 57 57 57 57 57 57 57 57 57 57 57 57 57 57 57 57 57 57 57 65 57 57 57 57 57 

14 0
0 1

1
26 21 0

2
