32 24
41 46 0 0 47 197 41 41 41 41 41 41 41 41 41 41 41 41 41 41 41 41 41 41 197 46 0 0 47 41 41 41 
57 215 114 115 216 57 65 57 57 57 57 65 57 57 57 57 57 65 57 57 57 57 57 57 65 215 114 115 216 65 57 57 
57 43 0 0 44 50 42 68 42 42 42 42 42 42 42 218 42 42 42 42 42 42 69 42 51 43 0 0 44 57 57 65 
65 219 0 0 44 199 0 0 0 0 0 0 0 0 0 0 0 0 0 0 0 0 0 0 44 43 0 0 48 42 69 42 
57 43 0 0 44 43 0 0 0 0 0 0 0 0 0 0 0 0 0 0 0 0 0 0 44 43 0 0 0 0 0 0 
57 43 0 0 44 43 0 0 0 0 0 47 46 0 0 0 0 47 46 0 0 0 0 0 44 215 89 93 82 82 85 0 
57 43 0 0 220 43 0 0 0 0 0 44 43 0 0 0 0 44 43 0 0 0 0 0 44 43 90 82 82 93 97 0 
57 43 0 0 44 43 0 0 0 0 0 44 219 0 0 0 0 220 43 0 0 0 0 0 44 43 81 0 0 0 0 0 
65 43 0 0 44 219 0 0 0 0 0 44 43 0 0 0 0 44 43 0 0 0 0 0 176 215 88 0 99 89 82 89 
57 43 0 0 44 215 85 0 0 0 0 44 219 0 0 0 0 220 43 0 0 0 0 0 44 215 88 0 94 90 85 92 
57 43 0 0 220 43 92 0 0 0 0 220 43 0 0 0 0 44 43 0 0 0 0 0 44 43 81 0 87 91 91 91 
57 43 0 0 44 43 87 82 95 85 0 44 219 0 0 0 0 220 43 0 0 0 0 0 44 43 94 0 0 0 0 0 
57 43 0 0 44 215 82 82 82 84 0 44 43 0 0 0 0 44 43 0 0 0 0 0 44 215 91 95 82 82 96 0 
57 43 0 0 44 43 0 0 0 0 0 44 43 0 0 0 0 44 43 0 0 0 0 0 44 43 0 0 0 0 0 0 
65 43 0 0 220 43 0 0 0 0 0 44 43 0 0 0 0 220 175 0 0 0 0 0 44 43 0 0 47 41 41 41 
57 43 0 0 44 43 0 0 0 0 0 44 43 0 0 0 0 44 43 0 0 0 0 0 44 43 0 0 44 65 57 57 
57 43 0 0 44 175 0 0 0 0 0 44 219 0 0 0 0 44 43 0 0 0 0 0 48 45 0 0 44 57 57 57 
57 43 0 0 44 43 0 0 0 0 0 44 43 0 0 0 0 44 43 0 0 0 0 0 0 0 0 0 44 57 57 57 
57 43 0 0 44 43 0 0 0 0 0 44 43 0 0 0 0 44 43 0 0 0 0 0 0 0 0 0 44 57 57 65 
57 43 0 0 48 45 0 0 0 0 0 44 43 0 0 99 98 44 49 41 41 46 0 0 0 0 0 0 44 57 57 57 
65 43 0 0 0 0 0 0 0 0 0 44 43 0 0 100 91 216 57 57 65 43 0 0 0 0 0 111 44 57 57 57 
57 199 0 0 0 0 0 0 0 223 0 44 43 0 0 0 0 140 57 57 57 43 0 0 223 0 0 81 44 57 57 57 
57 49 41 41 41 41 41 41 41 224 41 52 49 41 41 41 41 52 65 57 57 49 41 41 224 41 41 213 52 65 57 57 
57 57 57 57 65 57 57 57 57 57 65 57 57 57 65 57 57 57 57 57 57 57 65 57 57 57 57 57 57 57 57 57 

0 1
14 0

0

2
